|-----------------------------------------------------------------------------|
|                                                                             |
| |--------------------------|        |-----------------------|               |
| |..........................|        |.......................|               |
| |..........................+########+.......................|-------|       |
| |..........................|   #    |...............................|--|    |
| |..........................|   #    |..................................|--| |
| |----------+---------------|   #    |----+----------------|...............| |
|            #                 #############                |...............| |
|            #                 #     |-----+------|         |...............| |
|            #                 #     |............|         |...............| |
|            ###################     |............|   ######+...............| |
|            #                 #     |............|   #     |...............| |
|            #                 #     |-----+------|   #     |--------+------| |
| |----------+----------|      #           #          #              #        |
| |.....................|      #           #          #         |----+------| |
| |.....................|      ########################         |...........| |
| |.....................|      #           #                    |...........| |
| |.....................|      #    |------+--------------------|...........| |
| |.....................|      #    |.......................................| |
| |.....................+###########+.......................................| |
| |.....................|           |.......................................| |
| |---------------------|           |---------------------------------------| |
|                                                                             |
|-----------------------------------------------------------------------------|
